#E#############################
#  #  #        m        m     #
#  #  #  ####  #  #  ##########
#  #     #     #  #  #        #
#  #  #######  ####  #  #######
#        #  #  #  #     #  #  #
####  ####  ####  #  #  #  #  #
#  #     #     #     #  #     #
#  #  #  #  ####  #  #  ####  #
#     #  #        #  #    m   #
######################S########
