##E########
#  #     #
#  #  ####
#        #
####  #  #
#     #  #
#  #  ####
#  #     #
#  ####  #
#     #  #
#######S##