##E############################
   #     #  #     #  #     #  #
#  #  ####  #  ####  ####  #  #
#  #  #        #           #  #
#  #  #  #######  ####  ####  #
#                 #           S
###############################